-ANA: A suffix to names of persons or places, used to denote acollection of notable sayings, literary gossip, anecdotes, etc. Thus,Scaligerana is a book containing the sayings of Scaliger, Johnsonianaof Johnson, etc.
AGERATUM: A genus of plants, one species of which (A. Mexicanum) haslavender-blue flowers in dense clusters.
ALVEOLATE: Deeply pitted, like a honeycomb.
ANGIOSPERMATOUS: Same as Angiospermous.
APITPAT: With quick beating or palpitation; pitapat. Congreve.
APOTACTITE: One of a sect of ancient Christians, who, in supposed imitationof the first believers, renounced all their possessions.
BAHAISM: The religious tenets or practices of the Bahais.
BASISOLUTE: Prolonged at the base, as certain leaves.
BEDSTAFF: "A wooden pin stuck anciently on the sides of the bedstead, tohold the clothes from slipping on either side." Johnson.Hostess, accommodate us with a bedstaff. B. Jonson.Say there is no virtue in cudgels and bedstaves. Brome.
BESTAR: To sprinkle with, or as with, stars; to decorate with, or aswith, stars; to bestud. "Bestarred with anemones." W. Black.
BOLE: The trunk or stem of a tree, or that which is like it.Enormous elm-tree boles did stoop and lean. Tennyson.
BRISKET: That part of the breast of an animal which extends from thefore legs back beneath the ribs; also applied to the fore part of ahorse, from the shoulders to the bottom of the chest.
CANEBRAKE: A thicket of canes. Ellicott.
CARICATURIST: One who caricatures.
CHAMAL: The Angora goat. See Angora goat, under Angora.
CINCINNUS: A form of monochasium in which the lateral branches arisealternately on opposite sides of the false axis; -- called alsoscorpioid cyme. --Cin*cin"nal (#), a.
CURSORILY: In a running or hasty manner; carelessly.
DEFIGURE: To delineate. [Obs.]These two stones as they are here defigured. Weever.
DIPLOBLASTIC: Characterizing the ovum when it has two primary germinallayers.
DOUR: Hard; inflexible; obstinate; sour in aspect; hardy; bold.[Scot.]A dour wife, a sour old carlin. C. Reade.
EMPLASTIC: Fit to be applied as a plaster; glutinous; adhesive; as,emplastic applications.
FASCICLE: A small bundle or collection; a compact cluster; as, a fascicleof fibers; a fascicle of flowers or roots.
FRITHY: Woody. [Obs.] Skelton.
FUMERELL: See Femerell.
GLADFUL: Full of gladness; joyful; glad. [R.] -- Glad"ful*ness, n. [R.]Spenser.It followed him with gladful glee. Spenser.
GLOSSARIST: A writer of glosses or of a glossary; a commentator; ascholiast. Tyrwhitt.
GNARL: To growl; to snarl.And wolves are gnarling who shall gnaw thee first. Shak.
HARELD: The long-tailed duck. See Old Squaw.
HISTORIOGRAPHY: The art of employment of an historiographer.
INCOMPARED: Peerless; incomparable. [Obs.] Spenser.
INCUNABULUM: A work of art or of human industry, of an early epoch;especially, a book printed before A. D. 1500.
INDOCILITY: The quality or state of being indocile; dullness of intellect;unteachableness; intractableness.The stiffness and indocility of the Pharisees. W. Montagu.
INDOXYL: A nitrogenous substance, C8H7NO, isomeric with oxindol,obtained as an oily liquid.
JOHNSON GRASS: A tall perennial grass (Sorghum Halepense), valuable in theSouthern and Western States for pasture and hay. The rootstocks arelarge and juicy and are eagerly sought by swine. Called also Cubagrass, Means grass, Evergreen millet, and Arabian millet.
KEPHALIN: One of a group of nitrogenous phosphorized principles, supposedby Thudichum to exist in brain tissue.
LIMULUS: The only existing genus of Merostomata. It includes only a fewspecies from the East Indies, and one (Limulus polyphemus) from theAtlantic coast of North America. Called also Molucca crab, king crab,horseshoe crab, and horsefoot.
LOMBARD: Of or pertaining to Lombardy, or the inhabitants of Lombardy.
LONGIROSTER: One of the Longirostres.
METELY: According to measure or proportion; proportionable;proportionate. [Obs.]
MILLWRIGHT: A mechanic whose occupation is to build mills, or to set uptheir machinery.
MOP: A made-up face; a grimace. "What mops and mowes it makes!"Beau. & Fl.
MORIGERATION: Obsequiousness; obedience. [Obs.] Evelyn.
NOTHINGISM: Nihility; nothingness. [R.]
OPINIATED: Opinionated. [Obs.]
OSMUND: A fern of the genus Osmunda, or flowering fern. The mostremarkable species is the osmund royal, or royal fern (Osmundaregalis), which grows in wet or boggy places, and has large bipinnatefronds, often with a panicle of capsules at the top. The rootstockcontains much starch, and has been used in stiffening linen.
OTHERNESS: The quality or state of being other or different; alterity;oppositeness.
OVERSWAY: To bear sway over.
PELICOSAURIA: A suborder of Theromorpha, including terrestrial reptiles fromthe Permian formation.
PHARISEAN: Following the practice of Pharisees; Pharisaic. [Obs.]"Pharisean disciples." Milton.
PHOTOGRAPHOMETER: An instrument for determining the sensibility of the platesemployed in photographic processes to luminous rays.
PICKERY: Petty theft. [Scot.] Holinshed.
PLEUROPTERA: A group of Isectivora, including the colugo.
POTTEEN: See Poteen.
PUTRIDNESS: Putridity. Floyer.
PYCNOSTYLE: See under Intercolumniation. -n.
QUININIC: Pertaining to, or designating, a nitrogenous acid obtained as ayellow crystalline substance by the oxidation of quinine.
REENJOYMENT: Renewed enjoiment.
RHAPSODIZE: To utter as a rhapsody, or in the manner of a rhapsody Sterne.
RHYTHMICS: The department of musical science which treats of the length ofsounds.
RICINIC: Pertaining to, or derived from, castor oil; formerly,designating an acid now called ricinoleic acid.
ROYALET: A petty or powerless king. [R.]there were at this time two other royalets, as only kings by hisleave. Fuller.
SCHEELIUM: The metal tungsten. [Obs.]
SUBSECUTE: To follow closely, or so as to overtake; to pursue. [Obs.]To follow and detain him, if by any possibility he could besubsecuted and overtaken. E. Hall.
SYMPOSIAC: Of or pertaining to compotations and merrymaking; happeningwhere company is drinking together; as, symposiac meetings.Symposiac disputations amongst my acquaintance. Arbuthnot.
TELEOCEPHIAL: An extensive order of bony fishes including most of the commonmarket species, as bass, salmon, cod, perch, etc.
TELLURAL: Of or pertaining to the earth. [R.]
TETRAGON: A plane figure having four sides and angles; a quadrangle, as asquare, a rhombus, etc.
TOUSEL: Same as Tousle. [Colloq.]
TROPHIED: Adorned with trophies.The trophied arches, storied halls, invade. Pope.
TRUNCHEONED: Having a truncheon.
ULVA: A genus of thin papery bright green seaweeds including thekinds called sea lettuce.
UNBLOODY: Not bloody. Dryden. Unbloody sacrifice. (a) A sacrifice inwhich no victim is slain. (b) (R. C. Ch.) The Mass.
UNDERRUN: To run or pass under; especially (Naut.), to pass along andunder, as a cable, for the purpose of taking it in, or of examiningit.
UNDERWENT: imp. of Undergo.
WATER VIOLET: See under Violet.
ZECHIN: See Sequin.
ZEQUIN: See Sequin.
